0 0 0 0 0 0 0 0 0 0 0 0 0 0 0
0 0 0 0 23 0 0 0 0 0 0 0 0 0 0 0
30 31 0 0 22 0 0 0 0 0 0 46 47 0 0
32 33 0 0 0 0 0 0 0 0 0 48 49 0 0
0 0 0 0 0 0 0 0 0 51 0 0 0 56 0
0 0 0 0 0 0 0 0 0 52 0 58 0 57 0
0 0 0 0 0 0 0 0 0 0 53 54 55 0 0
0 0 0 0 0 0 0 0 0 0 0 0 0 0 0
34 38 35 36 37 39 0 0 0 0 0 0 0 0 0
45 0 0 0 0 50 0 0 0 0 0 0 0 0 0
43 0 0 0 0 41 0 0 0 0 0 0 0 0 0
44 0 0 0 0 42 0 0 0 0 0 0 0 0 0